1.........................
000.......................
000.......................
..........................
..........................
..........................
..........................
....000......000000.....00
...00000....00000000...000
...0...0....00....00...000
..........................
..........................
................A.........