wwwwwwwwwwwwwww
w.q..c.q......w
wgwqw..wq..c..w
w.q.....wqw...w
wqw.......q...w
w.q.......wqwqw
w.wqw....wq...w
w...q........Aw
wwwwwwwwwwwwwww
