wwwwwwwwwwwwwww
w......w.A.w..w
w......qw.wq..w
w..qwq........w
w....wqwqw....w
w..b....w...w.w
w..wqwgwq...q.w
w..s..q....b..w
wwwwwwwwwwwwwww
