wwwwwwwwwwwwwwww
w..oo......A...w
ww..-...oo...www
ww..-...xx...oow
ww-b-.wwwwww.xxw
ww..-........xxw
w.xx-....oww...w
wwww-....x.....w
w-b.ww...x-c-..w
w--.xx...x.....w
w..w...........w
w.....c...e....w
wwwwwwwwwwwwwwww