wwwwwwwwwwwwwwww
w...o.xx.o....xw
w...oooooo...o.w
w....xxx....o.ow
wx..........oxow
wwwwwwwwww...o.w
wb-...co.......w
w--........Ao..w
wooo........-..w
w......x....-x.w
wc--.....x..-..w
w---..e.....b--w
wwwwwwwwwwwwwwww