wwwwwwwwwwwwwwww
w..--c-.....xoow
w..----....e..xw
w..oxxo........w
w........oo....w
w.--b--..xx.o..w
w..xx.......xoow
w......o.....xxw
w.....xxx..-...w
w..A.......bo..w
w...oo...oo-...w
w...xx...xx.x..w
wwwwwwwwwwwwwwww