wwwwwwwwwwwwwwww
wx..o.o....ox.ow
w..............w
woo..o.....-.w.w
w......wwww-xw.w
wb-.....o....wxw
w--....Ao...owxw
w...o........x.w
wc-.x..ooxx-.w.w
w...x.......o..w
w--.e......b--.w
w......o...o.oow
wwwwwwwwwwwwwwww