wwwwwwwwwwwwwww
w.e........o..w
w-........b-..w
w....o....o..ow
wxo.o.....oxoow
www........oxxw
wb....o.....xxw
w-..Ao....o.xxw
wo..o.....-...w
w....wwwwx-x..w
w.o......o....w
wcx..ooxxo-...w
wwwwwwwwwwwwwww