wwwwwwwwwwwwwwwwwww
w+++++3+++++++++++w
w+1++++++++++2++++w
w+++++++w+++++++++w
w+++++++w+++++++++w
w++++A++w+++++++++w
w+++++++w+++1+++++w
w+++++++w+++++++++w
w+3+++++++++++++++w
w+++++++++++++2+++w
wwwwwwwwwwwwwwwwwww